type octile
height 22
width 28
map
@@@@@@@@@@TTTTTTTTT@@@@@@@@@
@@@@@@@@@@TT......TTTT@@@@@@
@@@@@@@@@@TT.TT....TTTTTT@T@
@@TTTTTTTTTT..T..TTTTTTTTTT@
@@TT.........TT..TTTTTTTTTT@
@@TT.............TTT...TTTT@
@@TT..TTT................TT@
@@TT.......TTT...TTTTTT..TT@
@@TT.TTTTT...T...........TT@
T@TT........TTTT.........TT@
@@TT.............TTTT....TTT
T@TTT.TTT.........TT.....TTT
@@TTT.....T.TTTT.........TTT
@@TTT....TTTTTTT...........@
@@TTT....TTTTTTT....TTT....@
@@TTT.TT..T@TTTT...........@
@@TTT.....T@TTTT....TTTTTTT@
@@TTT....TT@TTTT...TTTTTTTT@
@@TTTTTTTTTTTTTTTTTTTTTTTTT@
@@@@@@@TTTTTT@@@@@@@@@@@@@@@
@@@@@@@@T@@@T@@@@@@@@@@@@@@@
@@@@@@@@@@T@@@@@@@@@@@@@@@@@
agents:7
0.12,2,15,10
1.12,11,26,13
2.21,8,18,2
3.21,5,12,11
4.7,4,24,14
5.9,16,14,8
6.4,4,17,17
7.5,7,16,16