type octile
height 17
width 17
map
@@@@@@@@@@@@@@@@@
@.........@.@...@0
@.@@@@@@@.@.@@@.@1
@...@.@.........@2
@.@@@.@@@.@@@@@@@3
@.....@.@.@.....@4
@.@@@@@.@@@.@.@@@5
@...........@...@6
@.@@@.@@@.@@@.@@@7
@.@.@...@.@.....@8
@.@.@.@.@@@@@@@.@9
@...@.@.@.@.@...@0
@.@@@@@@@.@.@@@.@1
@...........@.@.@2
@.@@@.@@@.@@@.@@@3
@...@...@.......@4
@@@@@@@@@@@@@@@@@
 012345678901234